АДЕЛАИДА	АДА
АДЕЛИНА	АДА
АЛА	АЛА
АЛЕВТИНА	АЛА
АЛИНА	АЛА
АЛИСА	АЛА
АЛЛА	АЛА
АЛЕКСАНДРА	АЛЕКСАНДР
САНЯ	АЛЕКСАНДР
САША	АЛЕКСАНДР
САШКА	АЛЕКСАНДР
ШУРА	АЛЕКСАНДР
АЛЁХА	АЛЕКСЕЙ
АЛЁША	АЛЕКСЕЙ
АЛЕКСЕЙ	АЛЕКСЕЙ
ЛЁША	АЛЕКСЕЙ
АНА	АНА
ЮЛИАНА	АНА
АНАСТАСИЯ	АНАСТАСИЯ
НАСТЯ	АНАСТАСИЯ
АНАТОЛИЙ	АНАТОЛИЙ
ТОЛЯ	АНАТОЛИЙ
ТОНЯ	АНАТОЛИЙ
ТОША	АНАТОЛИЙ
АНДРЕЙ	АНДРЕЙ
АНДРЕЙКА	АНДРЕЙ
АННА	АННА
АНТОН	АНТОНЯ
АНТОНЯ	АНТОНЯ
АНТОХА	АНТОНЯ
АРСЕНИЙ	АРСЕНИЙ
СЕНЯ	АРСЕНИЙ
АГНЕССА	АСЯ
АГНИЯ	АСЯ
АСЯ	АСЯ
ТАИСИЯ	АСЯ
АГАФОН	АФОНЯ
АФАНАСИЙ	АФОНЯ
АФОНИЙ	АФОНЯ
АФОНЯ	АФОНЯ
БЕЛА	БЕЛА
БЕЛКА	БЕЛА
БЕЛЛА	БЕЛА
БЕЛЯ	БЕЛА
БОРИМИР	БОРИС
БОРИС	БОРИС
БОРИСКА	БОРИС
БОРИСЛАВ	БОРИС
БОРЯ	БОРИС
СЛАВА	БОРИСЛАВ
ВАДИМКА	ВАДИМ
ВАДИША	ВАДИМ
ВАДЮША	ВАДИМ
ВАДЯ	ВАДИМ
ВАЛЯ	ВАЛЕНТИН
ВАЛЕРА	ВАЛЕРИЙ
ВАЛЕРИАН	ВАЛЕРИЙ
ВАЛЕРИЙ	ВАЛЕРИЙ
ВАРА	ВАРВАРА
ВАРЯ	ВАРВАРА
ВАСЁНА	ВАСИЛИЙ
ВАСЁНЯ	ВАСИЛИЙ
ВАСИЛЁК	ВАСИЛИЙ
ВАСИЛИЙ	ВАСИЛИЙ
ВАСИЛИСА	ВАСИЛИЙ
ВАСИЛЛА	ВАСИЛИЙ
ВАСС	ВАСИЛИЙ
ВАССА	ВАСИЛИЙ
ВАСЯ	ВАСИЛИЙ
ВАСЯЙ	ВАСИЛИЙ
ВАСЯНЯ	ВАСИЛИЙ
ВАСЯТА	ВАСИЛИЙ
ВАСЯХА	ВАСИЛИЙ
ВАСЯША	ВАСИЛИЙ
ВЕНЕДИКТ	ВЕНЯ
ВЕНЕДИКТА	ВЕНЯ
ВЕНЕРА	ВЕНЯ
ВЕНЯ	ВЕНЯ
ВЕРА	ВЕРА
ВЕРАНЯ	ВЕРА
ВЕРАХА	ВЕРА
ВЕРАША	ВЕРА
ВЕРКА	ВЕРА
ВЕРОНИКА	ВЕРА
ВИКА	ВИКТОР
ВИКТОР	ВИКТОР
ВИКТОРИЯ	ВИКТОР
ВИКТУСЯ	ВИКТОР
ВИТЁК	ВИКТОР
ВИТЯ	ВИКТОР
ВИЛА	ВИЛА
ВИЛЕН	ВИЛА
ВИЛЕНА	ВИЛА
ВИЛОРА	ВИЛА
ВИОЛА	ВИЛА
ВИСА	ВИССАРИОН
ВИССАРА	ВИССАРИОН
ВИССАРИОН	ВИССАРИОН
ВИСЯ	ВИССАРИОН
ВИТА	ВИТА
ВИТАЛИЙ	ВИТА
ВИТАЛИК	ВИТА
ВИТАЛЯ	ВИТА
ВИОЛЕТТА	ВИТА
ВАВА	ВЛАДИМИР
ВЛАДИМИР	ВЛАДИМИР
ВОВА	ВЛАДИМИР
ДИМА	ВЛАДИМИР
ВОЛОДЯ	ВЛАДИМИР
ВЛАДА	ВЛАДЯ
ВЛАДИЛЕН	ВЛАДЯ
ВЛАДИЛЕНА	ВЛАДЯ
ВЛАДИСЛАВ	ВЛАДЯ
ВЛАДИСЛАВА	ВЛАДЯ
ВЛАДЛЕНА	ВЛАДЯ
ВЛАДЯ	ВЛАДЯ
ВОЛЯ	ВСЕВОЛОД
ВСЕВОЛОД	ВСЕВОЛОД
СЕВА	ВСЕВОЛОД
ГАЛИНА	ГАЛИНА
ГАЛИНКА	ГАЛИНА
ГАЛИХА	ГАЛИНА
ГАЛКА	ГАЛИНА
ГЕННАДИЙ	ГЕНА
ГЕНРИХ	ГЕНА
ГЕНЯ	ГЕНА
ГЕОРГИЙ	ГЕРА
ГЕРАСИМ	ГЕРА
ГЕРЯ	ГЕРА
ГЛЕБКА	ГЛЕБ
ГРИХА	ГРИГОРИЙ
ГРИША	ГРИГОРИЙ
ДАРЬЯ	ДАРЬЯ
ДАРЯ	ДАРЬЯ
ДАША	ДАРЬЯ
ДАШУХА	ДАРЬЯ
ДЕН	ДЕНИС
ДЕНИС	ДЕНИС
ДЕНИСКА	ДЕНИС
ДЕНУСЯ	ДЕНИС
ДИАНА	ДИАНА
ДИНА	ДИАНА
ДМИТРИЙ	ДМИТРИЙ
МИТЯ	ДМИТРИЙ
МИТЯЙ	ДМИТРИЙ
ЕВГЕНИЯ	ЕВГЕНИЙ
ЖЕНЯ	ЕВГЕНИЙ
ДУСЯ	ЕВДОКИЯ
ЕВДОКИЯ	ЕВДОКИЯ
ЕКАТЕРИНА	ЕКАТЕРИНА
КАТЮ	ЕКАТЕРИНА
КАТЮХА	ЕКАТЕРИНА
КАТЮША	ЕКАТЕРИНА
КАТЯ	ЕКАТЕРИНА
ЕЛЕНА	ЕЛЕНА
ЛЕНА	ЕЛЕНА
ЕЛИЗАВЕТА	ЕЛИЗАВЕТА
ЛИЗА	ЕЛИЗАВЕТА
ЕМЕЛЬЯН	ЕМЕЛЬЯН
ЕМЕЛЯ	ЕМЕЛЬЯН
ЖАНКА	ЖАННА
ЖАНУСЯ	ЖАННА
ЗИНА	ЗИНАИДА
ЗИНАИДА	ЗИНАИДА
ЗИНКА	ЗИНАИДА
ИДА	ЗИНАИДА
ЗОЙКА	ЗОЙКА
ЗОЯ	ЗОЙКА
ВАНЮРА	ИВАН
ВАНЮСЯ	ИВАН
ВАНЮТА	ИВАН
ВАНЮТЯ	ИВАН
ВАНЮХА	ИВАН
ВАНЮША	ИВАН
ВАНЯ	ИВАН
ГОША	ИГОРЬ
ГУЛЯ	ИГОРЬ
ЕГОР	ИГОРЬ
ЖОРА	ИГОРЬ
ИГОРЁК	ИГОРЬ
ИГОРЬ	ИГОРЬ
ИЗА	ИЗАБЕЛЛА
ИЗАБЕЛЛА	ИЗАБЕЛЛА
ИЛЬЯ	ИЛЬЯ
ИЛЮХА	ИЛЬЯ
ИЛЮША	ИЛЬЯ
ИНА	ИНА
ИНЕССА	ИНА
ИННА	ИНА
ИННОКЕНТИЙ	ИНА
ИНГА	ИНА
ИОСИФ	ИОСИФ
ИОСЯ	ИОСИФ
ОСЯ	ИОСИФ
АРИНКА	ИРИНА
АРИША	ИРИНА
ИРА	ИРИНА
ИРИНА	ИРИНА
КИРА	КИРИЛЛ
КИРИЛЛ	КИРИЛЛ
КЛАВА	КЛАВА
КЛАВДИАН	КЛАВА
КЛАВДИЯ	КЛАВА
КЛАВДИЙ	КЛАВА
КОНСТАНТИН	КОНСТАНТИН
КОСТЯ	КОНСТАНТИН
КСЕНИЯ	КСЕНИЯ
КСЕНЯ	КСЕНИЯ
КСЮША	КСЕНИЯ
ЛЕВ	ЛЁВА
ЛАРА	ЛАРИСА
ЛАРИСА	ЛАРИСА
ЛЁНЯ	ЛЕОНИД
ЛЕОНИД	ЛЕОНИД
ЛИДИЯ	ЛИДИЯ
ЛИДЯ	ЛИДИЯ
ЛИЛЯ	ЛИДИЯ
ЛИЛИЯ	ЛИЛИЯ
ЛИЯ	ЛИЛИЯ
ЛЮДА	ЛЮДМИЛА
ЛЮДМИЛА	ЛЮДМИЛА
МАКС	МАКСИМ
МАКСИМ	МАКСИМ
МАРИНА	МАША
МАРИЯ	МАША
МАШКА	МАША
МИХА	МИХАИЛ
МИХАИЛ	МИХАИЛ
МИША	МИХАИЛ
НАДЯ	НАДЕЖДА
НАТА	НАТАЛИЯ
НАТАЛИЯ	НАТАЛИЯ
НАТАЛЬЯ	НАТАЛИЯ
КОЛЯ	НИКОЛАЙ
НИКОЛАЙ	НИКОЛАЙ
НИНА	НИНА
НИТА	НИНА
КСАНА	ОКСАНА
ОКСАНА	ОКСАНА
ЛЕГА	ОЛЕГ
ОЛЕГ	ОЛЕГ
ОЛЬГА	ОЛЬГА
ОЛЯ	ОЛЬГА
ПЁТР	ПЁТР
ПЕТЯ	ПЁТР
ПАВА	ПАВЕЛ
ПАВЛИК	ПАВЕЛ
ПАВЛУНЯ	ПАВЕЛ
ПАВЛУСЯ	ПАВЕЛ
ПАВЛУХА	ПАВЕЛ
ПАВЛУША	ПАВЕЛ
ПАХА	ПАВЕЛ
ПАША	ПАВЕЛ
ПАШКА	ПАВЕЛ
ПЛАТОН	ПЛАТОН
ПЛАТОША	ПЛАТОН
ПОЛИНА	ПОЛИНА
ПОЛЯ	ПОЛИНА
ПАРАША	ПРАСКОВЬЯ
ПРАСКОВЬЯ	ПРАСКОВЬЯ
РАИСА	РАИСА
РАИСКА	РАИСА
РОМА	РОМАН
РОМАН	РОМАН
РОСТИСЛАВ	РОСТИСЛАВ
РОСТЯ	РОСТИСЛАВ
ЛАНА	СВЕТЛАНА
СВЕТА	СВЕТЛАНА
СВЕТЛАНА	СВЕТЛАНА
СЁМА	СЕМЁН
СЕМЁН	СЕМЁН
СЕМЁНКА	СЕМЁН
СЕРЁЖА	СЕРГЕЙ
СЕРГЕЙ	СЕРГЕЙ
СЕРЖ	СЕРГЕЙ
СОНА	СОФЬЯ
СОНЯ	СОФЬЯ
СОФЬЯ	СОФЬЯ
СТЁПА	СТЕПАН
СТЕПАН	СТЕПАН
ТАНЮША	ТАТЬЯНА
ТАНЯ	ТАТЬЯНА
ТАТЬЯНА	ТАТЬЯНА
ЮЛИЯ	ЮЛИЯ
ЮЛЯ	ЮЛИЯ
ЮРА	ЮРИЙ
ЮРИЙ	ЮРИЙ
ЯРОСЛАВ	ЯРОСЛАВ
ЯРОСЛАВА	ЯРОСЛАВ
ЯСЯ	ЯРОСЛАВ
