#	
-	
N	
Й	
САНКТ	
№	
ПЕРВАЯ	1
ПЕРВОЕ	1
ПЕРВЫЙ	1
ВТОРАЯ	2
ВТОРОЕ	2
ВТОРОЙ	2
ТРЕТИЕ	3
ТРЕТИЙ	3
ТРЕТЬЕ	3
ТРЕТЬЯ	3
БАНК	БНК
БАНКОВСКАЯ	БНК
БАНКОВСКИЙ	БНК
БАНКОВСКОЕ	БНК
ГОРНОДОБЫВАЮЩАЯ	ДБВ
ГОРНОДОБЫВАЮЩЕЕ	ДБВ
ГОРНОДОБЫВАЮЩИЙ	ДБВ
ДОБЫВАЮЩАЯ	ДБВ
ДОБЫВАЮЩЕЕ	ДБВ
ДОБЫВАЮЩИЙ	ДБВ
ЗАВОД	ЗВД
КОМБИНАТ	КМБ
МОСКОВСКАЯ	МСК
МОСКОВСКИЕ	МСК
МОСКОВСКИЙ	МСК
МОСКОВСКОЕ	МСК
ПРОИЗВОДСТВЕНАЯ	ПРЗВ
ПРОИЗВОДСТВЕННАЯ	ПРЗВ
ПРОИЗВОДСТВЕННОЕ	ПРЗВ
ПРОИЗВОДСТВЕННЫЙ	ПРЗВ
ПРОИЗВОДСТВЕНОЕ	ПРЗВ
ПРОИЗВОДСТВЕНЫЙ	ПРЗВ
ПРОМЫШЛЕНАЯ	ПРОМ
ПРОМЫШЛЕННАЯ	ПРОМ
ПРОМЫШЛЕННОЕ	ПРОМ
ПРОМЫШЛЕННЫЙ	ПРОМ
ПРОМЫШЛЕНОЕ	ПРОМ
ПРОМЫШЛЕНЫЙ	ПРОМ
ЛЕНИНГРАДСКИЙ	ПТБ
ПЕТЕРБУРГСКАЯ	ПТБ
ПЕТЕРБУРГСКИЙ	ПТБ
ПЕТЕРБУРЖСКАЯ	ПТБ
ПЕТЕРБУРЖСКИЙ	ПТБ
ВСЕРОССИЙСКАЯ	РСК
ВСЕРОССИЙСКИЙ	РСК
ВСЕРОССИЙСКОЕ	РСК
РОСИЙСКАЯ	РСК
РОСИЙСКИЙ	РСК
РОСИЙСКОЕ	РСК
РОССИЙСКАЯ	РСК
РОССИЙСКИЕ	РСК
РОССИЙСКИЙ	РСК
РОССИЙСКОЕ	РСК
РУСКАЯ	РСК
РУСКИЙ	РСК
РУСКОЕ	РСК
РУССКАЯ	РСК
РУССКИЕ	РСК
РУССКИЙ	РСК
РУССКОЕ	РСК
ФАБРИКА	ФБ
ФИНАНСОВАЯ	ФНС
ФИНАНСОВОЕ	ФНС
ФИНАНСОВЫЙ	ФНС
